10.ox
..oooo...o
..oo...o..
o.......o.
o..o.ooo..
..o.o.....
...o....o.
.oooo...o.
o....o....
..o....o..
...o...o.o
